1111111111111111111111111
1000000000000000000000001
1011101110111110111011101
1010101010100010101010101
1010101010100010101010101
1011101110111110111011101
1000000000000000000000001
1111101111111111111011111
1000101000000000001010001
1000101111111111111010001
1000100000000000000010001
1111101111110111111011111
000000144000000044100000000
1111101111111111111011111
1000100000000000000010001
1000101111111111111010001
1000101000000000001010001
1111101111111111111011111
1000000000000000000000001
1011101110111110111011101
1010101010100010101310101
1010101010100010101010101
1011101110111110111011101
1000000000000000000000001
1111111111111111111111111